0mm0mm0mm0000mm
0mm0mm0mm0mmmmm
00000000000000m
m0000000000000m
m0000mmm000000m
m0000mmm000000m
m0000mmm000000m
m0000mmm000000m
m0000000000000m
mmmmmmmmmmmmm0m
m0000000000000m
m0mmmmmmmmm0mmm
m0mmmmmmmmm0mmm
m0000mm00000mmm
mmmmmmmammmmmmm